#########
#     P #
#  X  ###
#     #  
#  O  #  
#######   
